a.......
....X...
..CXX...
...X....
.H......
........
....B...
........