a.........
....X..H..
..CXX.....
...X......
..........
..H.....D.
..........
....B.....
..........
..........